8 8 8 8 8 8 8 8 8 8 8 8 8 8 8 8 8 8 8 8 8 8 8 8 8 8 8 8 8 8 8 8 8 8 8 8 8 8 8 8 8 8 8 8 8 8 8 8 8 8
8 8 8 8 8 8 8 8 8 8 8 8 8 8 8 8 8 8 8 8 8 8 8 8 8 8 8 8 8 8 8 8 8 8 8 8 8 8 8 8 8 8 8 8 8 8 8 8 8 8
8 8 8 8 8 8 8 8 8 8 8 8 8 8 8 8 8 8 8 8 8 8 8 8 8 8 8 8 8 8 8 8 8 8 8 8 8 8 8 8 8 8 8 8 8 8 8 8 8 8
8 8 8 8 8 8 8 8 8 8 8 8 8 8 8 8 8 8 8 8 8 8 8 8 8 8 8 8 8 8 8 8 8 8 8 8 8 8 8 8 8 8 8 8 8 8 8 8 8 8
8 8 8 8 8 8 8 8 8 8 8 8 8 8 8 8 8 8 8 8 8 8 8 8 8 8 8 8 8 8 8 8 8 8 8 8 8 8 8 8 8 8 8 8 8 8 8 8 8 8
8 8 8 8 8 8 8 8 8 8 8 8 8 8 8 8 8 8 8 8 8 8 8 8 8 8 8 8 8 8 8 8 8 8 8 8 8 8 8 8 8 8 8 8 8 8 8 8 8 8
8 8 8 8 8 8 8 8 8 8 8 8 8 8 8 8 8 8 8 8 8 8 8 8 8 8 8 8 8 8 8 8 8 8 8 8 8 8 8 8 8 8 8 8 8 8 8 8 8 8
8 8 8 8 8 8 8 8 8 8 8 8 8 8 8 8 8 8 8 8 8 8 8 8 8 8 8 8 8 8 8 8 8 8 8 8 8 8 8 8 8 8 8 8 8 8 8 8 8 8
8 8 8 8 8 8 5 5 8 8 8 8 8 5 5 5 5 5 5 5 5 5 5 5 5 5 5 5 5 5 5 5 5 5 5 5 5 5 5 5 5 8 8 8 8 8 8 8 8 8
8 8 8 8 8 5 5 5 5 5 5 5 5 5 5 5 5 5 5 5 5 5 5 5 5 5 5 5 5 5 5 5 5 5 5 5 5 5 5 5 5 5 5 8 8 8 8 8 8 8
8 8 8 8 5 5 0 0 0 0 0 0 0 0 0 0 0 0 0 0 0 0 0 0 0 0 0 0 0 0 0 0 0 0 0 0 0 0 5 5 5 5 5 8 8 8 8 8 8 8
8 8 8 8 5 5 0 0 1 1 1 1 1 1 1 1 1 1 1 1 1 1 0 0 0 0 0 0 0 0 3 0 0 0 0 0 0 0 0 0 0 0 5 5 8 8 8 8 8 8
8 8 8 8 5 5 0 0 1 2 2 2 2 2 1 2 2 1 2 2 2 1 0 0 0 0 0 0 0 0 0 0 0 0 0 4 0 0 0 0 0 0 5 5 5 8 8 8 8 8
8 8 8 5 5 0 0 0 1 2 2 2 2 2 1 2 2 1 2 2 2 1 0 0 0 0 5 5 5 5 5 5 5 5 5 5 5 5 0 0 0 0 0 5 5 8 8 8 8 8
8 8 8 5 5 0 1 1 1 2 2 2 2 2 2 2 2 1 2 2 2 1 0 0 0 5 5 5 5 5 5 5 5 5 5 5 5 5 0 0 0 0 0 5 5 8 8 8 8 8
8 8 8 5 5 0 1 2 2 2 2 2 2 2 2 2 2 1 2 2 2 1 0 3 0 5 5 5 5 5 5 5 5 5 5 5 5 5 5 5 0 0 5 5 8 8 8 8 8 8
8 8 8 5 5 0 1 2 2 2 2 2 2 2 1 2 2 1 1 2 1 1 0 0 5 5 5 5 5 5 5 5 5 5 5 5 5 5 5 5 0 0 5 5 8 8 8 8 8 8
8 8 8 5 5 0 1 1 1 1 1 1 1 1 1 2 2 2 2 2 2 1 0 0 5 5 5 5 5 5 5 5 5 5 5 5 5 5 5 5 0 0 5 5 5 8 8 8 8 8
8 8 8 5 5 0 1 2 2 2 2 2 2 2 2 2 2 2 2 2 2 1 0 5 5 5 5 5 5 5 5 5 5 5 5 5 5 5 5 5 0 0 0 5 5 8 8 8 8 8
8 8 8 5 5 0 1 2 2 2 2 2 2 2 2 2 2 2 2 2 2 1 0 5 5 5 5 5 5 5 5 5 5 5 5 5 5 5 5 5 0 0 0 5 5 5 8 8 8 8 
8 8 8 5 5 0 1 2 2 2 2 2 2 2 2 2 2 2 2 2 2 1 0 0 5 5 5 5 5 5 5 5 5 5 5 5 5 5 5 5 0 0 0 5 5 5 8 8 8 8
8 8 8 5 5 0 1 2 2 2 2 2 2 2 2 2 2 2 2 2 2 1 0 0 0 5 5 5 5 5 5 5 5 5 5 5 5 5 5 5 0 0 0 0 5 5 8 8 8 8 
8 8 5 5 5 0 1 1 1 1 1 1 1 1 1 1 1 1 1 2 2 1 0 0 0 5 5 5 5 5 5 5 5 5 5 5 5 5 5 5 0 0 0 0 5 5 8 8 8 8
8 8 5 5 5 0 0 0 0 0 0 0 0 0 0 0 0 0 1 5 5 1 0 0 0 5 5 5 5 5 5 5 5 5 5 5 5 5 5 5 0 0 0 0 5 5 8 8 8 8
8 8 5 5 5 0 0 0 0 0 0 0 0 0 0 0 0 0 3 5 5 4 0 0 0 5 5 5 5 5 5 5 5 5 5 5 5 5 5 5 0 0 0 5 5 5 5 8 8 8
8 8 5 5 5 0 0 0 0 0 0 0 0 0 0 0 0 0 0 5 5 0 0 0 0 5 5 5 5 5 5 5 5 5 5 5 5 5 5 0 0 0 0 0 5 5 5 5 8 8
8 8 5 5 5 0 0 0 3 0 0 0 0 0 0 0 0 0 0 5 5 0 0 0 5 5 5 5 5 5 5 5 5 5 5 5 5 5 5 0 0 0 0 0 5 5 5 5 8 8
8 8 5 5 5 0 0 0 0 0 0 0 0 9 0 0 0 0 0 5 5 5 5 5 5 5 5 5 5 5 5 5 5 5 5 5 5 5 0 0 0 3 0 0 5 5 5 8 8 8
8 8 5 5 5 0 0 0 0 0 0 9 0 0 0 0 0 0 0 0 5 5 5 5 5 5 5 5 5 5 5 5 5 5 5 5 5 5 0 0 0 0 0 0 5 5 5 8 8 8
8 8 5 5 5 0 0 0 0 9 0 0 0 0 0 0 0 0 0 0 0 5 5 5 5 5 0 0 5 5 5 5 5 5 5 5 0 0 0 0 0 0 0 0 5 5 8 8 8 8
8 8 5 5 5 5 0 0 0 0 0 0 0 0 9 0 0 0 0 0 0 5 5 5 7 0 0 9 0 0 5 5 5 5 5 0 0 0 0 0 9 0 0 0 5 5 8 8 8 8 
8 8 8 5 5 5 0 0 9 0 0 9 0 0 0 0 0 0 0 0 0 5 5 5 5 0 0 0 0 0 0 0 0 0 0 0 0 0 0 0 0 0 0 5 5 8 8 8 8 8
8 8 8 5 5 5 0 0 0 0 0 0 3 0 0 0 0 0 0 0 0 5 5 5 5 0 0 0 0 0 0 0 0 0 0 9 0 0 0 0 0 0 0 5 5 5 5 8 8 8 
8 8 8 5 5 5 0 0 0 0 9 0 0 0 0 0 0 0 0 0 0 5 5 5 5 0 0 0 0 0 0 0 0 0 0 0 0 0 0 0 0 0 0 5 5 5 5 8 8 8
8 8 8 5 5 5 0 0 0 0 0 0 0 0 9 0 0 0 0 0 0 5 5 5 5 0 0 0 0 0 0 9 0 0 0 0 0 9 0 0 0 0 0 5 5 5 5 5 8 8 
8 8 8 5 5 5 0 0 0 0 0 0 0 0 0 0 0 0 0 0 0 5 5 5 5 0 0 0 0 0 0 0 0 0 9 0 0 0 0 0 0 0 0 5 5 5 5 5 8 8
8 8 8 8 5 5 0 0 0 0 0 0 0 0 0 0 0 9 0 0 0 5 5 5 5 0 0 0 0 0 0 0 3 0 0 0 0 0 0 0 0 0 0 5 5 5 5 5 8 8 
8 8 8 8 8 5 5 5 5 5 5 5 0 0 0 0 0 0 0 0 0 5 5 5 5 0 0 4 0 0 0 0 0 0 0 0 0 0 0 0 0 0 0 5 5 5 5 5 8 8
8 8 8 8 8 8 5 5 5 5 5 5 0 0 0 0 0 0 0 0 0 5 5 5 5 0 0 0 0 0 0 0 0 0 0 0 3 0 0 0 0 0 0 5 5 5 5 8 8 8 
8 8 8 8 8 8 8 8 8 8 5 5 0 0 0 0 0 4 0 0 0 5 5 5 5 0 0 0 0 9 0 0 9 0 0 0 0 0 0 0 0 0 5 5 5 5 5 8 8 8
8 8 8 8 8 8 8 8 8 8 5 5 0 0 0 0 0 0 0 0 0 6 5 5 5 0 0 0 0 0 0 0 0 0 0 0 0 0 0 0 0 0 5 5 5 5 8 8 8 8
8 8 8 8 8 8 8 8 8 8 5 5 0 0 0 0 0 0 0 0 0 5 5 5 5 0 0 0 0 0 0 0 0 0 0 0 0 0 0 0 0 0 5 5 5 8 8 8 8 8
8 8 8 8 8 8 8 8 8 8 5 5 5 0 0 0 0 0 0 0 0 5 5 5 5 0 0 0 0 0 0 0 0 0 0 0 0 0 0 0 0 5 5 5 5 8 8 8 8 8
8 8 8 8 8 8 8 8 8 8 5 5 5 5 0 0 0 0 0 0 5 5 5 5 5 5 5 5 5 5 5 5 5 5 5 5 5 5 5 5 5 5 5 5 8 8 8 8 8 8
8 8 8 8 8 8 8 8 8 8 5 5 5 5 5 5 5 5 5 5 5 5 5 5 5 7 5 5 5 5 5 5 5 5 5 5 5 5 5 5 5 5 8 8 8 8 8 8 8 8
8 8 8 8 8 8 8 8 8 8 5 5 5 5 5 5 5 5 5 5 5 5 5 5 5 5 5 5 8 8 8 8 5 5 5 5 5 5 8 8 8 8 8 8 8 8 8 8 8 8 
8 8 8 8 8 8 8 8 8 8 8 8 8 8 8 8 8 8 8 5 5 5 5 8 8 8 8 8 8 8 8 8 8 8 5 5 5 8 8 8 8 8 8 8 8 8 8 8 8 8 
8 8 8 8 8 8 8 8 8 8 8 8 8 8 8 8 8 8 8 8 8 8 8 8 8 8 8 8 8 8 8 8 8 8 8 8 8 8 8 8 8 8 8 8 8 8 8 8 8 8
8 8 8 8 8 8 8 8 8 8 8 8 8 8 8 8 8 8 8 8 8 8 8 8 8 8 8 8 8 8 8 8 8 8 8 8 8 8 8 8 8 8 8 8 8 8 8 8 8 8
8 8 8 8 8 8 8 8 8 8 8 8 8 8 8 8 8 8 8 8 8 8 8 8 8 8 8 8 8 8 8 8 8 8 8 8 8 8 8 8 8 8 8 8 8 8 8 8 8 8
